06 06 06 06 06 06 06 06 06 04 04 06 06 06 06 06 06 06 06 06
06 06 06 06 06 06 06 00 00 04 04 00 00 06 06 06 06 06 06 06
06 06 06 06 06 06 00 00 00 04 04 00 00 00 06 06 06 06 06 06
06 00 00 00 00 00 00 00 00 04 04 00 00 00 00 00 00 00 00 06
06 00 00 00 00 00 00 00 00 04 04 00 00 00 00 00 00 00 00 06
06 00 00 00 00 00 00 00 00 04 04 00 00 00 00 00 00 00 00 06
06 00 00 00 00 00 00 00 00 04 04 00 00 00 00 00 00 00 00 06
06 00 00 00 00 00 00 00 04 04 04 04 00 00 00 00 00 00 00 06
06 00 00 00 00 00 00 04 04 04 04 04 04 00 00 00 00 00 00 06
06 16 08 08 08 08 08 07 08 08 08 08 07 08 08 08 08 08 17 06
06 18 09 09 09 09 09 07 09 09 09 09 07 09 09 09 09 09 19 06
06 06 06 06 06 06 06 04 06 06 06 06 04 06 06 06 06 06 06 06
06 06 06 06 06 06 06 04 06 06 06 06 04 06 06 06 06 06 06 06
06 06 06 06 06 06 06 04 04 04 04 04 04 06 06 06 06 06 06 06
06 06 06 06 06 06 06 06 06 04 04 06 06 06 06 06 06 06 06 06
06 06 06 06 06 06 06 06 06 04 04 06 06 06 06 06 06 06 06 06
06 06 06 06 06 06 06 06 06 04 04 06 06 06 06 06 06 06 06 06
06 00 00 00 00 00 00 00 04 04 04 04 00 00 00 00 00 00 00 06
06 00 00 00 00 00 00 00 04 04 04 04 00 00 00 00 00 00 00 06
06 16 08 08 08 08 08 08 07 08 08 07 08 08 08 08 08 08 17 06
06 18 09 09 09 09 09 09 07 09 09 07 09 09 09 09 09 09 19 06
06 06 06 06 06 00 00 00 04 06 06 04 00 00 00 06 06 06 06 06
06 00 00 00 00 00 00 00 04 04 04 04 00 00 00 00 00 00 00 06
06 00 00 00 00 00 00 00 00 04 04 00 00 00 00 00 00 00 00 06
06 00 00 00 00 00 00 00 00 04 04 00 00 00 00 00 00 00 00 06
06 00 00 00 00 00 04 04 04 04 04 04 04 04 00 00 00 00 00 06
06 00 00 00 00 04 04 00 06 06 06 06 00 04 04 00 00 00 00 06
06 00 00 00 00 04 00 06 06 06 06 06 06 00 04 00 00 00 00 06
06 00 00 00 00 04 06 06 06 06 06 06 06 06 04 00 00 00 00 06
06 16 08 08 08 07 08 08 08 08 08 08 08 08 07 08 08 08 17 06
06 18 09 09 09 07 09 09 09 09 09 09 09 09 07 09 09 09 19 06
06 06 06 06 06 04 06 06 06 06 06 06 06 06 04 06 06 06 06 06
06 06 06 06 06 04 00 00 00 00 00 00 00 00 04 06 06 06 06 06
06 00 00 00 00 04 00 00 00 00 00 00 00 00 04 00 00 00 00 06
06 00 00 00 00 04 00 00 00 00 00 00 00 00 04 00 00 00 00 06
06 00 00 00 00 04 04 00 00 00 00 00 00 04 04 00 00 00 00 06
06 00 00 00 00 00 04 00 00 00 00 00 00 04 00 00 00 00 00 06
06 00 00 00 00 00 04 00 00 00 00 00 00 04 00 00 00 00 00 06
06 16 08 08 08 08 07 08 08 08 08 08 08 07 08 08 08 08 17 06
06 10 05 05 05 05 07 05 05 05 05 05 05 07 05 05 05 05 11 06
06 18 09 09 09 09 07 09 09 09 09 09 09 07 09 09 09 09 19 06
06 00 00 00 00 00 04 06 06 06 06 06 06 04 00 00 00 00 00 06
06 00 00 00 00 00 04 06 06 06 06 06 06 04 00 00 00 00 00 06
06 00 00 00 00 00 04 04 06 06 06 06 04 04 00 00 00 00 00 06
06 00 00 00 00 00 00 04 04 04 04 04 04 00 00 00 00 00 00 06
06 06 00 00 00 00 00 00 04 04 04 04 00 00 00 00 00 00 06 06
06 06 06 00 00 00 00 00 00 04 04 00 00 00 00 00 00 06 06 06
06 06 06 06 00 00 00 00 00 04 04 00 00 00 00 00 06 06 06 06
06 06 06 06 06 00 00 00 00 04 04 00 00 00 00 06 06 06 06 06
06 06 06 06 06 06 06 06 06 06 06 06 06 06 06 06 06 06 06 06