06 06 06 06 06 06 06 06 06 04 04 06 06 06 06 06 06 06 06 06
06 06 06 06 06 06 06 06 00 04 04 00 06 06 06 06 06 06 06 06
06 06 06 06 06 06 06 00 00 04 04 00 00 06 06 06 06 06 06 06
06 06 06 06 06 06 00 00 00 04 04 00 00 00 06 06 06 06 06 06
06 06 06 06 06 00 00 00 00 04 04 00 00 00 00 06 06 06 06 06
06 06 06 06 00 00 00 00 00 04 04 00 00 00 00 00 06 06 06 06
06 06 06 00 00 00 00 00 00 04 04 00 00 00 00 00 00 06 06 06
06 06 00 00 00 00 00 00 04 04 04 04 00 00 00 00 00 00 06 06
06 06 06 06 06 06 06 06 07 08 08 07 06 06 06 06 06 06 06 06
06 06 06 06 06 06 06 06 07 09 09 07 06 06 06 06 06 06 06 06
06 00 00 00 00 00 00 00 04 04 04 04 00 00 00 00 00 00 00 06
06 00 00 00 00 00 00 00 00 04 04 00 00 00 00 00 00 00 00 06
06 00 00 00 00 00 02 00 00 04 04 00 00 00 03 00 00 00 00 06
06 00 00 00 00 00 00 00 00 04 04 00 00 02 00 00 00 00 00 06
06 00 00 00 00 00 00 00 00 04 04 00 00 00 00 00 00 00 00 06
06 00 00 00 02 00 00 04 04 04 04 04 00 00 00 00 00 00 00 06
06 00 00 00 00 00 04 04 04 04 04 04 04 04 01 00 00 00 00 06
06 00 00 00 00 04 04 04 04 04 04 04 04 04 04 00 00 00 00 06
06 00 00 00 04 04 04 04 04 04 04 04 04 04 04 04 00 00 00 06
06 06 06 06 07 06 06 06 06 06 06 06 06 06 06 07 06 06 06 06
06 00 00 00 04 06 06 06 06 06 06 06 06 06 06 04 00 00 00 06
06 00 00 00 04 04 06 06 06 06 06 06 06 06 04 04 00 00 00 06
06 00 00 00 00 04 04 06 16 08 08 17 06 04 04 00 00 00 00 06
06 00 00 00 00 00 04 04 18 09 09 19 04 04 00 00 00 00 00 06
06 00 00 00 00 02 00 04 04 04 04 04 04 00 00 02 00 00 00 06
06 00 00 00 00 00 00 00 04 04 04 04 00 00 00 00 00 00 00 06
06 00 00 00 00 00 00 00 00 04 04 01 00 00 00 00 00 00 00 06
06 06 00 00 00 00 00 00 04 04 04 04 00 00 00 00 00 00 06 06
06 06 06 00 00 00 00 00 04 04 04 04 00 00 00 02 00 06 06 06
06 06 06 06 16 08 08 08 07 08 08 07 08 08 08 17 06 06 06 06
06 06 06 06 18 09 09 09 07 09 09 07 09 09 09 19 06 06 06 06
06 06 06 00 00 00 00 00 04 04 04 04 00 00 00 00 00 06 06 06
06 06 00 00 00 00 00 06 06 04 04 06 06 00 00 00 00 00 06 06
06 00 00 00 00 00 00 06 04 04 04 04 06 00 00 03 00 00 00 06
06 00 00 00 01 00 06 04 04 04 04 04 04 06 00 00 00 00 00 06
06 00 00 00 00 06 04 04 04 04 04 04 04 04 06 00 00 00 00 06
06 00 00 00 06 04 04 00 02 00 00 02 00 04 04 06 00 00 00 06
06 00 00 00 06 04 03 00 01 00 00 01 00 02 04 06 00 00 00 06
06 16 08 08 08 07 08 08 08 08 08 08 08 08 07 08 08 08 17 06
06 18 09 09 09 07 09 09 09 09 09 09 09 09 07 09 09 09 19 06
06 00 00 00 00 07 02 00 00 01 00 02 00 03 07 00 00 00 00 06
06 00 00 00 00 04 04 03 00 00 00 00 02 04 04 00 01 00 00 06
06 06 00 00 00 00 04 04 04 04 04 04 04 04 00 00 00 00 06 06
06 06 06 00 02 03 00 04 04 04 04 04 04 00 00 00 00 06 06 06
06 06 06 06 00 00 00 04 04 04 04 04 04 00 03 00 06 06 06 06
06 06 06 06 06 00 00 04 04 04 04 04 04 00 00 06 06 06 06 06
06 06 06 06 06 06 00 00 00 04 04 00 00 00 06 06 06 06 06 06
06 06 06 06 06 06 06 00 00 04 04 00 00 06 06 06 06 06 06 06
06 06 06 06 06 06 06 06 00 04 04 00 06 06 06 06 06 06 06 06
06 06 06 06 06 06 06 06 06 06 06 06 06 06 06 06 06 06 06 06