06 00 00 00 06 04 06 00 00 00 00 00 00 06 04 06 00 00 00 06
06 00 00 00 06 04 06 00 00 00 00 00 00 06 04 06 00 00 00 06
06 00 00 00 06 04 06 00 00 00 00 00 00 06 04 06 00 00 00 06
06 00 00 00 06 04 06 00 00 00 00 00 00 06 04 06 00 00 00 06
06 00 00 00 06 04 06 00 00 00 00 00 00 06 04 06 00 00 00 06
06 00 00 00 06 04 06 00 00 00 00 00 00 06 04 06 00 00 00 06
06 00 00 00 06 04 06 00 00 00 00 00 00 06 04 06 00 00 00 06
06 00 00 00 06 04 06 00 00 00 00 00 00 06 04 06 00 00 00 06
08 08 08 08 08 07 08 08 08 08 08 08 08 08 07 08 08 08 08 08
09 09 09 09 09 07 09 09 09 09 09 09 09 09 07 09 09 09 09 09
06 00 00 00 00 04 06 06 06 06 06 06 06 06 04 00 00 00 00 06
06 00 00 00 00 04 16 08 08 08 08 08 08 17 04 00 00 00 00 06
06 00 00 00 00 04 10 05 05 05 05 05 05 11 04 00 00 00 00 06
06 00 00 00 00 04 10 05 05 05 05 05 05 11 04 00 00 00 00 06
06 00 00 00 00 04 10 05 05 05 05 05 05 11 04 00 00 00 00 06
06 00 00 00 00 04 18 09 09 09 09 09 09 19 04 00 00 00 00 06
06 00 00 00 00 04 04 04 04 00 00 04 04 04 04 00 00 00 00 06
06 00 00 00 00 00 00 00 04 00 00 04 00 00 00 00 00 00 00 06
08 08 08 08 08 08 08 08 07 08 08 07 08 08 08 08 08 08 08 08
09 09 09 09 09 09 09 09 07 09 09 07 09 09 09 09 09 09 09 09
06 00 00 00 00 00 00 00 04 06 06 04 00 00 00 00 00 00 00 06
06 00 00 00 00 00 00 00 04 06 06 04 00 00 00 00 00 00 00 06
06 00 00 00 00 00 00 04 04 00 00 04 04 00 00 00 00 00 00 06
06 00 00 00 00 00 04 04 00 00 00 00 04 04 00 00 00 00 00 06
06 00 00 00 00 04 04 00 00 00 00 00 00 04 04 00 00 00 00 06
06 00 00 00 04 04 00 00 00 00 00 00 00 00 04 04 00 00 00 06
06 00 00 00 04 00 00 00 00 00 00 00 00 00 00 04 00 00 00 06
06 00 00 00 04 00 00 00 00 00 00 00 00 00 00 04 00 00 00 06
08 08 08 08 07 08 08 08 08 08 08 08 08 08 08 07 08 08 08 08
09 09 09 09 07 13 13 13 13 13 13 13 13 13 13 07 09 09 09 09
06 00 00 00 04 04 04 04 04 04 04 04 04 04 04 04 00 00 00 06
06 00 00 00 04 04 04 04 04 04 04 04 04 04 04 04 00 00 00 06
06 00 00 00 00 04 04 04 04 04 04 04 04 04 04 00 00 00 00 06
06 00 00 00 00 00 04 04 04 04 04 04 04 04 00 00 00 00 00 06
06 00 00 00 00 00 00 04 04 04 04 04 04 00 00 00 00 00 00 06
06 00 00 00 00 00 00 00 04 04 04 04 00 00 00 00 00 00 00 06
06 00 00 00 00 00 00 00 04 04 04 04 00 00 00 00 00 00 00 06
06 00 00 00 00 00 00 00 04 00 00 04 00 00 00 00 00 00 00 06
08 08 08 08 08 08 08 08 07 08 08 07 08 08 08 08 08 08 08 08
09 09 09 09 09 09 09 09 07 09 09 07 09 09 09 09 09 09 09 09
06 00 00 00 00 00 00 00 04 06 06 04 00 00 00 00 00 00 00 06
06 00 00 00 00 00 00 00 04 06 06 04 00 00 00 00 00 00 00 06
06 00 00 00 00 00 00 00 04 06 06 04 00 00 00 00 00 00 00 06
06 00 00 00 00 00 00 00 04 04 04 04 00 00 00 00 00 00 00 06
06 00 00 00 00 00 00 00 04 04 04 04 00 00 00 00 00 00 00 06
06 06 06 06 00 00 00 00 04 04 04 04 00 00 00 00 06 06 06 06
06 06 06 06 06 00 00 00 04 04 04 04 00 00 00 06 06 06 06 06
06 06 06 06 06 06 00 00 04 04 04 04 00 00 06 06 06 06 06 06
06 06 06 06 06 06 06 00 04 04 04 04 00 06 06 06 06 06 06 06
06 06 06 06 06 06 06 06 06 06 06 06 06 06 06 06 06 06 06 06