06 06 06 06 06 06 06 06 06 04 04 06 06 06 06 06 06 06 06 06
06 00 00 00 00 00 00 00 00 04 04 00 00 00 00 00 00 00 00 06
06 00 00 00 00 00 00 00 06 04 04 06 00 00 00 00 00 00 00 06
06 00 00 00 00 00 00 00 00 04 04 00 00 00 00 00 00 00 00 06
06 00 00 00 00 00 06 00 06 04 04 06 00 06 00 00 00 00 00 06
06 00 00 00 00 06 04 04 04 04 04 04 04 04 06 00 00 00 00 06
06 00 00 00 00 00 04 00 00 00 00 00 00 04 00 00 00 00 00 06
06 00 00 00 00 06 04 00 00 00 00 00 00 04 06 00 00 00 00 06
08 08 08 08 08 08 07 08 08 08 08 08 08 07 08 08 08 08 08 08
05 05 05 05 05 05 07 05 05 05 05 05 05 07 05 05 05 05 05 05
05 05 05 05 23 09 07 09 09 09 09 09 09 07 09 22 05 05 05 05
09 09 09 09 19 06 04 06 06 06 06 06 06 04 06 18 09 09 09 09
06 00 00 00 00 00 04 01 00 02 00 01 00 04 00 00 00 00 03 06
06 00 02 00 01 00 04 00 00 00 03 00 00 04 00 00 00 00 00 06
06 00 00 00 02 00 04 00 00 00 02 00 00 04 00 00 03 00 01 06
06 00 00 03 00 00 04 00 00 01 00 00 00 04 00 00 00 00 00 06
06 00 03 00 00 00 04 00 01 00 00 00 02 04 00 00 02 00 02 06
06 06 06 06 06 00 04 06 06 06 06 06 06 04 06 06 06 06 06 06
06 08 08 08 08 08 07 08 08 08 08 08 08 07 08 08 08 08 08 08
06 09 09 09 09 09 07 09 09 09 09 09 09 07 09 09 09 09 09 09
06 00 00 00 00 00 04 00 00 00 00 00 00 04 00 00 00 00 00 06
06 00 00 00 00 00 04 00 00 00 00 00 00 04 00 00 00 00 00 06
06 00 00 00 00 00 04 00 03 00 00 00 03 04 00 00 00 00 01 06
06 00 00 00 00 00 04 00 00 00 02 00 01 04 00 00 00 02 00 06
06 00 00 01 04 04 04 00 01 00 00 00 00 04 04 04 00 00 00 06
06 00 00 00 04 00 00 00 06 06 06 06 00 00 00 04 00 00 00 06
06 00 02 00 04 00 00 06 06 06 06 06 06 00 00 04 00 03 00 06
06 00 00 00 04 00 06 06 06 06 06 06 06 06 00 04 00 00 00 06
08 08 08 08 07 08 08 08 08 08 08 08 08 08 08 07 08 08 08 08
09 09 09 09 07 09 09 09 09 09 09 09 09 09 09 07 09 09 09 09
06 00 00 00 00 00 00 00 00 00 00 00 00 00 00 00 00 00 00 06
06 00 00 00 00 16 08 08 08 08 08 08 08 08 17 00 03 00 00 06
06 00 03 00 00 10 05 05 23 09 09 22 05 05 11 00 00 01 00 06
06 00 00 00 00 10 05 05 11 06 06 10 05 05 11 00 00 00 00 06
06 00 00 02 00 18 22 05 21 08 08 20 05 23 19 00 00 00 02 06
06 00 00 00 00 00 18 09 22 05 05 23 09 19 00 00 00 00 00 06
06 00 00 00 00 00 00 00 18 09 09 19 00 00 00 00 01 00 00 06
06 00 00 00 00 00 00 00 00 00 00 00 00 00 00 00 00 00 00 06
08 08 08 08 08 08 08 08 07 08 08 07 08 08 08 08 08 08 08 08
09 09 09 09 09 09 09 09 07 09 09 07 09 09 09 09 09 09 09 09
06 06 06 06 06 00 02 00 04 06 06 04 00 00 00 06 06 06 06 06
06 00 00 00 00 00 00 00 04 06 06 04 00 00 00 00 00 00 00 06
06 00 00 00 00 00 00 00 04 02 00 04 00 00 00 00 00 01 00 06
06 00 00 02 00 00 00 00 04 04 04 04 00 00 00 00 00 00 00 06
06 00 00 00 00 00 00 00 00 04 04 00 00 00 00 01 00 00 00 06
06 00 01 00 00 01 00 00 00 04 04 00 00 00 00 00 00 00 00 06
06 00 00 00 00 00 00 00 00 04 04 00 00 00 03 00 00 03 00 06
06 00 00 00 00 00 00 00 00 04 04 00 00 00 00 00 00 00 00 06
06 00 00 00 00 00 03 00 00 04 04 00 00 00 00 00 00 00 00 06
06 06 06 06 06 06 06 06 06 06 06 06 06 06 06 06 06 06 06 06
