05 05 05 05 05 05 05 15 04 04 04 04 14 05 05 05 05 05 05 05
05 05 05 05 05 05 05 15 04 04 04 04 14 05 05 05 05 05 05 05
05 05 05 05 05 31 13 27 04 04 04 04 26 13 30 05 05 05 05 05
05 05 05 05 05 15 04 04 04 04 04 04 04 04 14 05 05 05 05 05
05 05 05 05 05 15 04 04 04 04 04 04 04 04 14 05 05 05 05 05
05 05 05 05 31 27 04 04 04 04 04 04 04 04 26 30 05 05 05 05
05 05 05 05 29 12 07 12 12 12 12 12 12 07 12 28 05 05 05 05
05 05 05 05 05 05 07 05 05 05 05 05 05 07 05 05 05 05 05 05
05 05 05 05 05 05 07 05 05 05 05 05 05 07 05 05 05 05 05 05
05 05 05 05 05 05 07 05 05 05 05 05 05 07 05 05 05 05 05 05
05 05 05 31 13 13 07 13 13 13 13 13 13 07 13 13 30 05 05 05
05 05 05 15 04 04 04 04 04 04 04 04 04 04 04 04 14 05 05 05
05 05 05 15 04 04 04 04 04 04 04 04 04 04 04 04 14 05 05 05
05 05 05 15 04 04 00 00 00 00 00 00 00 00 04 04 14 05 05 05
05 05 05 15 04 04 00 00 00 00 00 00 03 00 04 04 14 05 05 05
05 05 05 15 04 04 00 00 00 01 00 00 00 00 04 04 14 05 05 05
05 05 05 15 04 04 00 06 06 06 06 06 06 00 04 04 14 05 05 05
05 05 05 15 04 04 00 06 06 06 06 06 06 00 04 04 14 05 05 05
05 05 05 29 12 12 07 08 08 08 08 08 08 07 12 12 28 05 05 05
05 05 05 05 05 05 07 05 05 05 05 05 05 07 05 05 05 05 05 05
05 05 05 31 13 13 07 09 09 09 09 09 09 07 13 13 30 05 05 05
05 05 05 15 04 04 00 06 06 06 06 06 06 00 04 04 14 05 05 05
05 05 05 15 04 04 00 00 00 00 00 00 00 00 04 04 14 05 05 05
05 05 05 15 04 04 00 00 00 03 00 00 00 00 04 04 14 05 05 05
05 05 05 15 04 04 06 06 06 00 00 06 06 06 04 04 14 05 05 05
05 05 05 15 04 04 00 00 00 00 00 01 00 00 04 04 14 05 05 05
05 05 05 15 04 04 00 02 00 00 00 00 00 00 04 04 14 05 05 05
05 05 05 15 04 04 00 00 00 00 00 00 00 00 04 04 14 05 05 05
05 05 05 29 12 12 07 08 08 08 08 08 08 07 12 12 28 05 05 05
05 05 05 05 05 05 07 05 05 05 05 05 05 07 05 05 05 05 05 05
05 05 05 31 13 13 07 09 09 09 09 09 09 07 13 13 30 05 05 05
05 05 05 15 04 04 00 00 00 00 00 00 00 00 04 04 14 05 05 05
05 05 05 15 04 04 00 00 00 00 00 00 00 00 04 04 14 05 05 05
05 05 05 15 04 04 00 06 06 06 06 06 06 03 04 04 14 05 05 05
05 05 05 15 04 04 00 06 06 06 06 06 06 00 04 04 14 05 05 05
05 05 05 15 04 04 00 00 00 02 01 00 00 00 04 04 14 05 05 05
05 05 05 15 04 04 02 00 00 00 00 00 00 00 04 04 14 05 05 05
05 05 05 15 04 04 00 00 00 00 00 00 00 00 04 04 14 05 05 05
05 05 05 29 12 12 08 08 07 08 08 07 08 08 12 12 28 05 05 05
05 05 05 05 05 05 05 05 07 05 05 07 05 05 05 05 05 05 05 05
05 05 05 31 13 13 09 09 07 09 09 07 09 09 13 13 30 05 05 05
05 05 05 15 04 04 00 00 00 00 00 00 00 00 04 04 14 05 05 05
05 05 05 15 04 04 00 00 00 00 00 00 00 00 04 04 14 05 05 05
05 05 05 15 04 04 00 00 00 03 00 00 00 01 04 04 14 05 05 05
05 05 05 15 04 04 00 00 00 00 00 00 00 00 04 04 14 05 05 05
05 05 05 15 04 04 02 00 00 00 00 00 00 00 04 04 14 05 05 05
05 05 05 15 04 04 00 00 00 00 00 00 00 00 04 04 14 05 05 05
05 05 05 15 04 04 04 04 04 04 04 04 04 04 04 04 14 05 05 05
05 05 05 29 12 12 12 12 12 12 12 12 12 12 12 12 28 05 05 05
05 05 05 05 05 05 05 05 05 05 05 05 05 05 05 05 05 05 05 05