05 05 05 05 05 05 05 07 07 07 07 07 07 05 05 05 05 05 05 05
05 05 05 05 05 05 05 07 07 07 07 07 07 05 05 05 05 05 05 05
05 05 05 05 05 05 05 07 07 07 07 07 07 05 05 05 05 05 05 05
05 05 05 05 05 05 05 07 07 07 07 07 07 05 05 05 05 05 05 05
05 05 05 05 05 07 07 07 07 07 07 07 07 07 07 05 05 05 05 05
05 05 05 05 05 07 07 07 07 07 07 07 07 07 07 05 05 05 05 05
05 05 05 05 05 07 07 07 07 07 07 07 07 07 07 05 05 05 05 05
05 05 05 05 05 07 07 07 07 07 07 07 07 07 07 05 05 05 05 05
05 05 05 05 05 07 05 05 05 05 05 05 05 05 07 05 05 05 05 05
05 05 05 05 05 07 05 05 05 05 05 05 05 05 07 05 05 05 05 05
05 05 05 23 09 07 09 09 09 09 09 09 09 09 07 09 22 05 05 05
05 05 05 11 00 00 06 06 06 06 06 06 06 06 00 00 10 05 05 05
05 05 05 11 00 00 00 00 00 00 00 00 00 00 00 00 10 05 05 05
05 05 05 11 00 00 00 00 00 00 00 00 00 00 00 00 10 05 05 05
05 05 05 11 06 06 06 00 00 00 00 00 00 06 06 06 10 05 05 05
05 05 05 11 06 06 00 00 00 00 00 00 00 00 06 06 10 05 05 05
05 05 05 11 06 00 00 00 00 00 00 00 00 00 00 06 10 05 05 05
05 05 05 11 00 00 00 00 00 00 00 00 00 00 00 00 10 05 05 05
05 05 05 11 00 00 00 00 00 00 00 00 00 00 00 00 10 05 05 05
05 05 05 21 08 08 08 08 07 08 08 07 08 08 08 08 20 05 05 05
05 05 05 23 09 09 09 09 07 09 09 07 09 09 09 09 22 05 05 05
05 05 05 11 00 00 00 00 00 00 00 00 00 00 00 00 10 05 05 05
05 05 05 11 00 00 00 00 00 00 00 00 00 00 00 00 10 05 05 05
05 05 05 11 06 06 06 06 00 00 00 00 06 06 06 06 10 05 05 05
05 05 05 11 06 06 06 06 00 00 00 00 06 06 06 06 10 05 05 05
05 05 05 11 06 06 06 06 00 00 00 00 06 06 06 06 10 05 05 05
05 05 05 11 00 00 00 00 00 00 00 00 00 00 00 00 10 05 05 05
05 05 05 11 00 00 00 00 00 00 00 00 00 00 00 00 10 05 05 05
05 05 05 21 08 08 07 08 08 08 08 08 08 07 08 08 20 05 05 05
05 05 05 05 05 05 07 05 05 05 05 05 05 07 05 05 05 05 05 05
05 05 31 13 13 13 07 13 13 13 13 13 13 07 13 13 13 30 05 05
05 05 15 04 04 04 04 04 04 04 04 04 04 04 04 04 04 14 05 05
05 05 15 04 04 04 04 04 04 04 04 04 04 04 04 04 04 14 05 05
05 05 15 04 04 04 04 04 04 04 04 04 04 04 04 04 04 14 05 05
05 05 15 04 04 04 04 04 04 04 04 04 04 04 04 04 04 14 05 05
05 05 15 04 04 04 04 04 04 04 04 04 04 04 04 04 04 14 05 05
05 05 15 04 04 04 04 04 04 04 04 04 04 04 04 04 04 14 05 05
05 05 29 12 25 04 04 04 04 04 04 04 04 04 04 24 12 28 05 05
05 05 05 05 29 12 12 07 12 12 12 12 07 12 12 28 05 05 05 05
05 05 05 05 05 05 05 07 05 05 05 05 07 05 05 05 05 05 05 05
05 05 05 05 05 05 05 07 05 05 05 05 07 05 05 05 05 05 05 05
05 05 05 05 05 05 05 07 07 07 07 07 07 05 05 05 05 05 05 05
05 05 05 05 05 05 05 07 07 07 07 07 07 05 05 05 05 05 05 05
05 05 05 05 05 05 05 07 07 07 07 07 07 05 05 05 05 05 05 05
05 05 05 05 05 05 05 07 07 07 07 07 07 05 05 05 05 05 05 05
05 05 05 05 05 05 05 07 07 07 07 07 07 05 05 05 05 05 05 05
05 05 05 05 05 05 05 07 07 07 07 07 07 05 05 05 05 05 05 05
05 05 05 05 05 05 05 07 07 07 07 07 07 05 05 05 05 05 05 05
05 05 05 05 05 05 05 07 07 07 07 07 07 05 05 05 05 05 05 05
05 05 05 05 05 05 05 05 05 05 05 05 05 05 05 05 05 05 05 05
