6 0 0 0 6 4 6 0 0 0 0 0 0 6 4 6 0 0 0 6
6 0 0 0 6 4 6 0 0 0 0 0 0 6 4 6 0 0 0 6
6 0 0 0 6 4 6 0 0 0 0 0 0 6 4 6 0 0 0 6
6 0 0 0 6 4 6 0 0 0 0 0 0 6 4 6 0 0 0 6
6 0 0 0 6 4 6 0 0 0 0 0 0 6 4 6 0 0 0 6
6 0 0 0 6 4 6 0 0 0 0 0 0 6 4 6 0 0 0 6
6 0 0 0 6 4 6 0 0 0 0 0 0 6 4 6 0 0 0 6
6 0 0 0 6 4 6 0 0 0 0 0 0 6 4 6 0 0 0 6
8 8 8 8 8 7 8 8 8 8 8 8 8 8 7 8 8 8 8 8
9 9 9 9 9 7 9 9 9 9 9 9 9 9 7 9 9 9 9 9
6 0 0 0 0 4 6 6 6 6 6 6 6 6 4 0 0 0 0 6
6 0 0 0 0 4 16 8 8 8 8 8 8 17 4 0 0 0 0 6
6 0 0 0 0 4 10 5 5 5 5 5 5 11 4 0 0 0 0 6
6 0 0 0 0 4 10 5 5 5 5 5 5 11 4 0 0 0 0 6
6 0 0 0 0 4 10 5 5 5 5 5 5 11 4 0 0 0 0 6
6 0 0 0 0 4 18 9 9 9 9 9 9 19 4 0 0 0 0 6
6 0 0 0 0 4 4 4 4 0 0 4 4 4 4 0 0 0 0 6
6 0 0 0 0 0 0 0 4 0 0 4 0 0 0 0 0 0 0 6
8 8 8 8 8 8 8 8 7 8 8 7 8 8 8 8 8 8 8 8
9 9 9 9 9 9 9 9 7 9 9 7 9 9 9 9 9 9 9 9
6 0 0 0 0 0 0 0 4 6 6 4 0 0 0 0 0 0 0 6
6 0 0 0 0 0 0 0 4 6 6 4 0 0 0 0 0 0 0 6
6 0 0 0 0 0 0 4 4 0 0 4 4 0 0 0 0 0 0 6
6 0 0 0 0 0 4 4 0 0 0 0 4 4 0 0 0 0 0 6
6 0 0 0 0 4 4 0 0 0 0 0 0 4 4 0 0 0 0 6
6 0 0 0 4 4 0 0 0 0 0 0 0 0 4 4 0 0 0 6
6 0 0 0 4 0 0 0 0 0 0 0 0 0 0 4 0 0 0 6
6 0 0 0 4 0 0 0 0 0 0 0 0 0 0 4 0 0 0 6
8 8 8 8 7 8 8 8 8 8 8 8 8 8 8 7 8 8 8 8
9 9 9 9 7 13 13 13 13 13 13 13 13 13 13 7 9 9 9 9
6 0 0 0 4 4 4 4 4 4 4 4 4 4 4 4 0 0 0 6
6 0 0 0 4 4 4 4 4 4 4 4 4 4 4 4 0 0 0 6
6 0 0 0 0 4 4 4 4 4 4 4 4 4 4 0 0 0 0 6
6 0 0 0 0 0 4 4 4 4 4 4 4 4 0 0 0 0 0 6
6 0 0 0 0 0 0 4 4 4 4 4 4 0 0 0 0 0 0 6
6 0 0 0 0 0 0 0 4 4 4 4 0 0 0 0 0 0 0 6
6 0 0 0 0 0 0 0 4 4 4 4 0 0 0 0 0 0 0 6
6 0 0 0 0 0 0 0 4 0 0 4 0 0 0 0 0 0 0 6
8 8 8 8 8 8 8 8 7 8 8 7 8 8 8 8 8 8 8 8
9 9 9 9 9 9 9 9 7 9 9 7 9 9 9 9 9 9 9 9
6 0 0 0 0 0 0 0 4 6 6 4 0 0 0 0 0 0 0 6
6 0 0 0 0 0 0 0 4 6 6 4 0 0 0 0 0 0 0 6
6 0 0 0 0 0 0 0 4 6 6 4 0 0 0 0 0 0 0 6
6 0 0 0 0 0 0 0 4 4 4 4 0 0 0 0 0 0 0 6
6 0 0 0 0 0 0 0 4 4 4 4 0 0 0 0 0 0 0 6
6 6 6 6 0 0 0 0 4 4 4 4 0 0 0 0 6 6 6 6
6 6 6 6 6 0 0 0 4 4 4 4 0 0 0 6 6 6 6 6
6 6 6 6 6 6 0 0 4 4 4 4 0 0 6 6 6 6 6 6
6 6 6 6 6 6 6 0 4 4 4 4 0 6 6 6 6 6 6 6
6 6 6 6 6 6 6 6 6 6 6 6 6 6 6 6 6 6 6 6