6 6 6 6 6 6 6 6 6 4 4 6 6 6 6 6 6 6 6 6
6 6 6 6 6 6 6 6 0 4 4 0 6 6 6 6 6 6 6 6
6 6 6 6 6 6 6 0 0 4 4 0 0 6 6 6 6 6 6 6
6 6 6 6 6 6 0 0 0 4 4 0 0 0 6 6 6 6 6 6
6 6 6 6 6 0 0 0 0 4 4 0 0 0 0 6 6 6 6 6
6 6 6 6 0 0 0 0 0 4 4 0 0 0 0 0 6 6 6 6
6 6 6 0 0 0 0 0 0 4 4 0 0 0 0 0 0 6 6 6
6 6 0 0 0 0 0 0 4 4 4 4 0 0 0 0 0 0 6 6
6 6 6 6 6 6 6 6 7 8 8 7 6 6 6 6 6 6 6 6
6 6 6 6 6 6 6 6 7 9 9 7 6 6 6 6 6 6 6 6
6 0 0 0 0 0 0 0 4 4 4 4 0 0 0 0 0 0 0 6
6 0 0 0 0 0 0 0 0 4 4 0 0 0 0 0 0 0 0 6
6 0 0 0 0 0 0 0 0 4 4 0 0 0 0 0 0 0 0 6
6 0 0 0 0 0 0 0 0 4 4 0 0 0 0 0 0 0 0 6
6 0 0 0 0 0 0 0 0 4 4 0 0 0 0 0 0 0 0 6
6 0 0 0 0 0 0 4 4 4 4 4 0 0 0 0 0 0 0 6
6 0 0 0 0 0 4 4 4 4 4 4 4 4 0 0 0 0 0 6
6 0 0 0 0 4 4 4 4 4 4 4 4 4 4 0 0 0 0 6
6 0 0 0 4 4 4 4 4 4 4 4 4 4 4 4 0 0 0 6
6 6 6 6 7 6 6 6 6 6 6 6 6 6 6 7 6 6 6 6
6 0 0 0 4 6 6 6 6 6 6 6 6 6 6 4 0 0 0 6
6 0 0 0 4 4 6 6 6 6 6 6 6 6 4 4 0 0 0 6
6 0 0 0 0 4 4 6 8 8 8 8 6 4 4 0 0 0 0 6
6 0 0 0 0 0 4 4 9 9 9 9 4 4 0 0 0 0 0 6
6 0 0 0 0 0 0 4 4 4 4 4 4 0 0 0 0 0 0 6
6 0 0 0 0 0 0 0 4 4 4 4 0 0 0 0 0 0 0 6
6 0 0 0 0 0 0 0 0 4 4 0 0 0 0 0 0 0 0 6
6 6 0 0 0 0 0 0 4 4 4 4 0 0 0 0 0 0 6 6
6 6 6 0 0 0 0 0 4 4 4 4 0 0 0 0 0 6 6 6
6 6 6 6 8 8 8 8 7 8 8 7 8 8 8 8 6 6 6 6
6 6 6 6 9 9 9 9 7 9 9 7 9 9 9 9 6 6 6 6
6 6 6 0 0 0 0 0 4 4 4 4 0 0 0 0 0 6 6 6
6 6 0 0 0 0 0 6 6 4 4 6 6 0 0 0 0 0 6 6
6 0 0 0 0 0 0 6 4 4 4 4 6 0 0 0 0 0 0 6
6 0 0 0 0 0 6 4 4 4 4 4 4 6 0 0 0 0 0 6
6 0 0 0 0 6 4 4 4 4 4 4 4 4 6 0 0 0 0 6
6 0 0 0 6 4 4 0 2 0 0 2 0 4 4 6 0 0 0 6
6 0 0 0 6 4 3 0 1 0 0 1 0 2 4 6 0 0 0 6
6 8 8 8 8 7 8 8 8 8 8 8 8 8 7 8 8 8 8 6
6 9 9 9 9 7 9 9 9 9 9 9 9 9 7 9 9 9 9 6
6 0 0 0 0 7 2 0 0 1 0 2 0 3 7 0 0 0 0 6
6 0 0 0 0 4 4 3 0 0 0 0 2 4 4 0 0 0 0 6
6 6 0 0 0 0 4 4 4 4 4 4 4 4 0 0 0 0 6 6
6 6 6 0 0 0 0 4 4 4 4 4 4 0 0 0 0 6 6 6
6 6 6 6 0 0 0 4 4 4 4 4 4 0 0 0 6 6 6 6
6 6 6 6 6 0 0 4 4 4 4 4 4 0 0 6 6 6 6 6
6 6 6 6 6 6 0 0 0 4 4 0 0 0 6 6 6 6 6 6
6 6 6 6 6 6 6 0 0 4 4 0 0 6 6 6 6 6 6 6
6 6 6 6 6 6 6 6 0 4 4 0 6 6 6 6 6 6 6 6
6 6 6 6 6 6 6 6 6 6 6 6 6 6 6 6 6 6 6 6