6 0 0 0 0 0 0 0 6 4 4 6 0 0 0 0 0 0 0 6
6 0 0 0 0 0 0 0 6 4 4 6 0 0 0 0 0 0 0 6
6 0 0 0 0 0 0 0 6 4 4 6 0 0 0 0 0 0 0 6
6 0 0 0 0 0 0 0 6 4 4 6 0 0 0 0 0 0 0 6
6 0 0 0 6 6 6 6 6 4 4 6 6 6 6 6 0 0 0 6
6 0 0 0 6 4 4 4 4 4 4 4 4 4 4 6 0 0 0 6
6 0 0 6 6 4 0 0 0 0 0 0 0 0 4 6 6 0 0 6
6 0 6 6 6 4 0 0 0 0 0 0 0 0 4 6 6 6 0 6
6 8 8 8 8 7 8 8 8 8 8 8 8 8 7 8 8 8 8 6
6 9 9 9 9 7 9 9 9 9 9 9 9 9 7 9 9 9 9 6
6 0 0 0 0 4 6 6 6 6 6 6 6 6 4 0 0 0 0 6
6 0 0 0 0 4 0 6 6 6 6 6 6 0 4 0 0 0 0 6
6 0 0 0 0 4 0 0 6 6 6 6 0 0 4 0 0 0 0 6
6 0 0 0 0 4 0 0 0 6 6 0 0 0 4 0 0 0 0 6
6 0 0 0 0 4 0 0 0 0 0 0 0 0 4 0 0 0 0 6
6 0 0 0 0 4 4 4 0 0 0 0 4 4 4 0 0 0 0 6
6 0 0 0 0 0 0 4 0 0 0 0 4 0 0 0 0 0 0 6
6 0 0 0 0 0 0 4 0 0 0 0 4 0 0 0 0 0 0 6
6 8 8 8 8 8 8 7 8 8 8 8 7 8 8 8 8 8 8 6
6 9 9 9 9 9 9 7 9 9 9 9 7 9 9 9 9 9 9 6
6 0 0 0 0 0 0 4 6 6 6 6 4 0 0 0 0 0 0 6
6 0 0 0 0 0 0 4 0 0 0 0 4 0 0 0 0 0 0 6
6 0 0 0 0 0 0 4 4 4 4 4 4 0 0 0 0 0 0 6
6 0 0 0 0 0 0 4 4 4 4 4 4 0 0 0 0 0 0 6
6 0 0 0 0 0 0 4 4 4 4 4 4 0 0 0 0 0 0 6
6 0 0 0 0 0 0 4 4 4 4 4 4 0 0 0 0 0 0 6
6 0 0 0 0 0 0 0 4 0 0 4 0 0 0 0 0 0 0 6
6 0 0 0 0 0 0 0 4 0 0 4 0 0 0 0 0 0 0 6
6 8 8 8 8 8 8 8 7 8 8 7 8 8 8 8 8 8 8 6
6 10 5 5 5 5 5 5 7 5 5 7 5 5 5 5 5 5 11 6
6 10 5 5 5 5 5 5 7 7 7 7 5 5 5 5 5 5 11 6
6 10 5 5 5 5 5 5 7 5 5 7 5 5 5 5 5 5 11 6
6 10 5 5 5 5 5 5 7 5 5 7 5 5 5 5 5 5 11 6
6 10 5 5 5 5 5 5 7 5 5 7 5 5 5 5 5 5 11 6
6 9 9 9 9 9 9 9 7 9 9 7 9 9 9 9 9 9 9 6
6 0 0 0 0 0 0 4 4 0 0 4 4 0 0 0 0 0 0 6
6 0 0 0 0 4 4 4 0 6 6 0 4 4 4 0 0 0 0 6
6 0 0 0 0 4 0 0 0 0 0 0 0 0 4 0 0 0 0 6
6 8 8 8 8 7 8 8 8 8 8 8 8 8 7 8 8 8 8 6
6 9 9 9 9 7 9 9 9 9 9 9 9 9 7 9 9 9 9 6
6 6 6 6 0 4 0 0 0 0 0 0 0 0 4 0 6 6 6 6
6 6 6 6 0 4 0 0 0 0 0 0 0 0 4 0 6 6 6 6
6 6 6 6 0 4 0 0 0 0 0 0 0 0 4 0 6 6 6 6
6 6 0 0 0 4 4 4 4 4 4 4 4 4 4 0 0 0 6 6
6 0 0 0 0 0 0 0 0 4 4 0 0 0 0 0 0 0 0 6
6 0 0 0 0 0 0 0 0 4 4 0 0 0 0 0 0 0 0 6
6 0 0 0 0 0 0 0 0 4 4 0 0 0 0 0 0 0 0 6
6 0 0 0 0 0 0 0 0 4 4 0 0 0 0 0 0 0 0 6
6 0 0 0 0 0 0 0 0 4 4 0 0 0 0 0 0 0 0 6
6 6 6 6 6 6 6 6 6 6 6 6 6 6 6 6 6 6 6 6