06 06 06 06 06 06 00 06 06 06 06 06 06 00 06 06 06 06 06 06
06 00 00 00 00 00 00 00 00 00 00 00 03 00 00 00 00 00 00 06
06 00 00 00 00 00 00 00 00 00 00 00 00 00 00 00 00 00 00 06
06 00 00 00 01 00 00 00 02 00 00 00 00 00 00 00 01 00 00 06
06 00 00 00 00 00 00 00 00 00 00 00 00 00 00 00 00 00 00 06
06 00 02 00 00 16 07 08 08 08 08 08 08 07 17 00 00 00 00 06
06 00 00 00 16 20 07 05 05 05 05 05 05 07 21 17 00 00 00 06
06 00 00 16 20 05 07 05 05 05 05 05 05 07 05 21 17 00 00 06
06 06 16 20 05 05 07 05 05 05 05 05 05 07 05 05 21 17 06 06
06 06 10 05 05 05 07 05 05 05 05 05 05 07 05 05 05 11 06 06
06 06 18 22 05 05 07 05 05 05 05 05 05 07 05 05 23 19 06 06
06 00 02 18 22 05 07 05 05 05 05 05 05 07 05 23 19 00 00 06
06 00 00 00 18 22 07 05 05 05 05 05 05 07 23 19 00 00 00 06
06 00 00 00 00 18 07 09 09 09 09 09 09 07 19 00 00 00 00 06
06 00 00 01 00 00 00 00 00 00 00 00 00 00 00 00 00 00 00 06
06 00 00 01 00 00 00 00 00 00 00 00 00 00 00 03 00 00 00 06
06 00 00 00 00 00 00 00 00 00 00 00 02 00 00 00 00 00 00 06
06 00 00 00 00 01 03 02 00 00 00 00 00 00 00 00 00 01 00 06
06 00 00 00 00 00 00 00 00 00 00 00 00 00 00 00 00 00 00 06
06 06 06 06 06 06 07 06 06 06 06 06 06 07 06 06 06 06 06 06
06 06 06 06 06 06 07 00 06 06 06 06 03 07 06 06 06 06 06 06
06 00 00 00 00 00 00 00 06 06 06 06 00 00 00 00 00 00 00 06
06 00 00 00 00 00 00 00 00 00 00 00 00 00 00 00 00 00 00 06
06 00 00 00 00 00 00 00 00 00 00 00 00 00 00 00 00 01 00 06
06 00 00 00 00 00 00 00 00 03 00 00 00 00 02 00 00 00 00 06
06 00 00 00 00 03 00 00 00 00 00 00 00 00 00 00 00 00 00 06
06 00 00 00 00 00 00 00 06 06 06 06 00 00 00 00 01 00 00 06
06 00 00 01 00 00 00 00 06 06 06 06 00 00 00 00 00 00 00 06
06 06 06 06 07 06 06 06 06 06 06 06 06 06 06 07 06 06 06 06
06 06 06 00 07 00 00 00 00 00 00 00 00 00 00 07 00 06 06 06
06 00 00 00 00 00 00 00 00 00 00 00 00 00 00 00 00 00 00 06
06 00 00 00 00 00 00 00 00 00 03 00 03 00 00 00 00 00 00 06
06 00 00 00 01 00 00 00 00 00 00 00 00 00 00 00 00 00 00 06
06 00 00 00 00 00 00 02 00 00 00 00 00 00 02 00 00 00 00 06
06 00 00 00 00 03 00 00 00 00 00 00 00 00 00 00 00 00 00 06
06 00 00 00 00 00 00 00 00 06 06 00 00 00 00 00 00 00 00 06
06 00 00 00 00 00 00 00 06 06 06 06 00 00 00 00 01 00 00 06
06 00 00 00 00 00 00 06 06 06 06 06 06 00 00 00 00 00 00 06
06 06 06 06 06 07 06 06 06 06 06 06 06 06 07 06 06 06 06 06
06 06 06 06 06 07 06 06 06 06 06 06 06 06 07 06 06 06 06 06
06 00 00 00 00 00 00 06 06 06 06 06 06 00 00 00 00 00 00 06
06 00 00 00 02 00 00 00 06 06 06 06 00 00 00 03 00 00 00 06
06 00 00 00 00 00 00 00 00 06 06 00 00 00 00 00 00 00 00 06
06 00 00 00 00 00 00 00 00 00 00 00 00 00 00 00 03 00 00 06
06 00 00 00 00 00 00 00 00 00 00 00 00 00 00 00 00 00 00 06
06 00 00 00 00 02 00 00 00 00 00 00 00 00 00 00 00 00 00 06
06 00 00 00 00 00 00 00 00 00 00 00 00 00 00 00 00 00 00 06
06 00 00 00 00 00 00 00 00 00 00 01 01 00 00 00 00 00 00 06
06 00 00 00 00 00 00 00 00 00 00 00 00 00 00 00 00 00 00 06
06 06 06 06 06 06 06 06 06 06 06 06 06 06 06 06 06 06 06 06