05 11 00 00 00 00 00 00 00 04 04 00 00 00 00 00 00 00 10 05
05 11 00 00 00 00 00 00 00 04 04 00 00 00 00 00 00 00 10 05
05 11 00 00 00 00 00 00 00 04 04 00 00 00 01 00 00 00 10 05
05 11 00 00 00 00 02 01 00 04 04 00 00 00 00 00 00 00 10 05
05 11 00 00 00 00 00 00 00 04 04 00 00 00 00 00 00 00 10 05
05 11 00 00 00 00 01 00 00 04 04 03 00 03 00 00 00 00 10 05
05 11 00 00 00 00 00 00 04 04 04 04 00 00 00 00 00 00 10 05
05 11 00 00 00 00 00 00 04 00 00 04 00 00 00 00 00 00 10 05
05 11 00 00 00 00 00 00 04 02 00 04 00 00 00 00 00 00 10 05
05 21 08 08 08 08 08 08 07 06 06 07 08 08 08 08 08 08 20 05
05 05 05 05 05 05 05 05 07 00 00 07 05 05 05 05 05 05 05 05
05 23 09 09 09 09 09 09 07 00 00 07 09 09 09 09 09 09 22 05
05 11 00 00 00 00 00 00 04 00 00 04 00 00 00 00 00 00 10 05
05 11 00 00 00 00 00 00 04 00 00 04 00 00 02 00 00 00 10 05
05 11 00 00 01 00 00 00 04 00 00 04 00 00 00 00 00 00 10 05
05 11 00 00 00 06 06 06 04 01 00 04 06 06 06 00 00 00 10 05
05 11 00 00 00 04 04 04 04 00 00 04 04 04 04 00 00 00 10 05
05 11 00 00 00 04 00 00 00 00 00 00 00 00 04 00 00 00 10 05
05 11 00 00 00 04 00 00 00 00 03 00 02 00 04 00 03 00 10 05
05 21 08 08 08 07 08 08 08 08 08 08 08 08 07 08 08 08 20 05
05 23 09 09 09 07 09 09 09 09 09 09 09 09 07 09 09 09 22 05
05 11 00 00 00 04 00 06 06 06 06 06 06 00 04 00 00 00 10 05
05 11 00 00 00 04 00 03 06 06 06 06 00 00 04 00 00 00 10 05
05 11 00 00 01 04 04 04 04 04 04 04 04 04 04 00 00 00 10 05
05 11 00 00 00 00 00 00 00 04 04 00 00 00 00 00 00 00 10 05
05 11 00 00 00 02 00 00 00 04 04 00 01 00 00 00 00 00 10 05
05 11 00 00 00 00 00 00 04 04 04 04 03 00 00 00 00 00 10 05
05 11 00 00 00 00 00 00 04 06 06 04 00 00 00 00 00 00 10 05
05 11 00 00 00 00 00 00 04 06 06 04 00 00 00 00 00 00 10 05
05 21 08 08 08 08 08 08 07 08 08 07 08 08 08 08 08 08 20 05
05 05 05 05 05 05 05 05 07 05 05 07 05 05 05 05 05 05 05 05
05 05 05 05 05 05 23 09 07 09 09 07 09 22 05 05 05 05 05 05
05 05 05 05 23 09 19 06 04 04 04 04 06 18 09 22 05 05 05 05
23 09 09 09 19 06 06 06 00 04 04 00 06 06 06 18 09 09 09 22
11 06 06 06 06 00 00 00 02 04 04 00 00 00 00 06 06 06 06 10
11 00 00 00 00 00 00 00 03 04 04 00 00 00 00 00 00 00 00 10
11 00 00 00 00 00 00 00 00 04 04 00 00 02 00 00 00 00 00 10
11 00 00 00 00 00 00 00 00 04 04 00 00 00 00 00 00 00 00 10
21 08 08 08 08 08 08 07 08 08 08 08 07 08 08 08 08 08 08 20
05 05 05 05 05 05 05 07 05 05 05 05 07 05 05 05 05 05 05 05
05 23 09 09 09 09 09 07 09 09 09 09 07 09 09 09 09 09 22 05
05 11 00 00 00 00 06 04 00 00 00 00 04 06 00 00 00 00 10 05
05 11 00 00 00 00 06 04 00 00 01 00 04 06 00 00 00 00 10 05
05 11 00 00 02 00 06 04 00 00 00 00 04 06 00 01 00 00 10 05
05 11 00 00 00 00 06 04 03 00 00 00 04 06 00 00 00 00 10 05
05 11 00 00 00 02 06 04 04 04 04 04 04 06 00 00 03 00 10 05
05 11 00 00 00 00 06 06 06 04 04 06 06 06 00 00 00 00 10 05
05 11 00 00 00 00 00 00 06 04 04 06 00 00 00 00 00 00 10 05
05 21 08 08 08 08 08 08 08 12 12 08 08 08 08 08 08 08 20 05
05 05 05 05 05 05 05 05 05 05 05 05 05 05 05 05 05 05 05 05