05 11 06 06 06 06 06 01 06 06 06 06 00 06 06 06 06 06 10 05
05 11 00 00 00 00 00 00 00 00 00 00 00 00 00 00 00 00 10 05
05 11 00 00 00 00 00 00 00 00 00 03 00 00 00 00 00 00 10 05
05 11 06 00 00 01 00 00 00 00 00 00 00 00 00 00 00 06 10 05
05 11 06 06 00 00 00 00 00 02 00 00 00 00 00 00 06 06 10 05
05 11 06 06 06 00 00 00 00 00 00 00 00 00 00 06 06 06 10 05
05 11 06 06 06 06 00 00 02 00 00 00 00 00 06 06 06 06 10 05
05 11 06 06 06 06 06 00 00 00 00 03 00 06 06 06 06 06 10 05
05 11 06 06 06 06 06 07 06 06 06 06 07 06 06 06 06 06 10 05
05 11 06 06 06 06 06 07 06 06 06 06 07 06 06 06 06 06 10 05
05 15 00 00 00 00 01 00 00 00 00 00 00 00 00 00 00 00 14 05
05 15 04 00 00 00 00 00 00 00 00 00 03 00 02 00 00 04 14 05
05 15 04 04 04 00 00 00 00 00 02 00 00 00 00 04 04 04 14 05
05 15 04 04 04 04 00 00 00 00 00 00 00 00 04 04 04 04 14 05
05 15 04 04 04 04 04 04 04 04 04 04 04 04 04 04 04 04 14 05
05 29 25 04 04 04 04 04 04 04 04 04 04 04 04 04 04 24 28 05
05 05 29 25 04 04 04 04 04 04 04 04 04 04 04 04 24 28 05 05
05 05 05 29 25 04 04 04 04 04 04 04 04 04 04 24 28 05 05 05
05 05 05 05 29 12 07 12 12 12 12 12 12 07 12 28 05 05 05 05
05 05 05 05 05 05 07 05 05 05 05 05 05 07 05 05 05 05 05 05
05 31 13 13 13 13 07 13 13 13 13 13 13 07 13 13 13 13 30 05
05 15 04 04 04 04 04 04 04 04 04 04 04 04 04 04 04 04 14 05
05 15 04 04 04 04 04 24 12 12 12 12 25 04 04 04 04 04 14 05
05 15 04 04 04 04 04 14 05 05 05 05 15 04 04 04 04 04 14 05
05 15 04 04 04 04 04 14 05 05 05 05 15 04 04 04 04 04 14 05
05 15 04 04 04 04 04 14 05 05 05 05 15 04 04 04 04 04 14 05
05 29 25 04 04 04 04 26 13 13 13 13 27 04 04 04 04 24 28 05
05 05 29 25 04 04 04 04 04 04 04 04 04 04 04 04 24 28 05 05
05 05 05 29 12 12 12 07 12 12 12 12 07 12 12 12 28 05 05 05
05 05 05 05 05 05 05 07 05 05 05 05 07 05 05 05 05 05 05 05
05 05 05 05 31 13 13 07 13 13 13 13 07 13 13 30 05 05 05 05
05 05 05 05 15 04 04 04 04 04 04 04 04 04 04 14 05 05 05 05
05 05 05 05 15 04 04 04 04 04 04 04 04 04 04 14 05 05 05 05
05 05 05 05 15 04 04 04 04 04 04 04 04 04 04 14 05 05 05 05
05 05 05 05 15 04 04 04 04 04 04 04 04 04 04 14 05 05 05 05
05 05 05 05 15 04 04 04 04 04 04 04 04 04 04 14 05 05 05 05
05 05 05 05 15 04 04 04 04 04 04 04 04 04 04 14 05 05 05 05
05 05 05 05 15 04 04 04 04 04 04 04 04 04 04 14 05 05 05 05
05 05 05 05 29 12 12 12 07 12 12 07 12 12 12 28 05 05 05 05
05 05 05 05 05 05 05 05 07 05 05 07 05 05 05 05 05 05 05 05
05 05 05 05 05 05 05 31 07 13 13 07 30 05 05 05 05 05 05 05
05 05 05 05 05 05 05 15 04 04 04 04 14 05 05 05 05 05 05 05
05 05 05 05 05 05 05 15 04 04 04 04 14 05 05 05 05 05 05 05
05 05 05 05 05 05 05 15 04 04 04 04 14 05 05 05 05 05 05 05
05 05 05 05 05 05 05 15 04 04 04 04 14 05 05 05 05 05 05 05
05 05 05 05 05 05 05 15 04 04 04 04 14 05 05 05 05 05 05 05
05 05 05 05 05 05 05 15 04 04 04 04 14 05 05 05 05 05 05 05
05 05 05 05 05 05 05 15 04 04 04 04 14 05 05 05 05 05 05 05
05 05 05 05 05 05 05 15 04 04 04 04 14 05 05 05 05 05 05 05
05 05 05 05 05 05 05 15 04 04 04 04 14 05 05 05 05 05 05 05