06 06 06 06 06 06 06 06 06 04 04 06 06 06 06 06 06 06 06 06
06 00 00 00 00 00 00 00 06 04 04 06 00 00 00 00 00 00 00 06
06 00 00 00 00 00 00 01 06 04 04 06 00 02 00 00 00 00 00 06
06 00 00 00 00 00 00 03 06 04 04 06 00 00 00 01 00 00 00 06
06 00 00 00 06 06 06 06 06 04 04 06 06 06 06 06 00 00 00 06
06 00 00 00 06 04 04 04 04 04 04 04 04 04 04 06 00 02 00 06
06 00 00 06 06 04 00 00 00 02 00 03 00 00 04 06 06 00 00 06
06 00 06 06 06 04 00 00 00 00 00 00 00 00 04 06 06 06 00 06
06 16 08 08 08 07 08 08 08 08 08 08 08 08 07 08 08 08 17 06
06 18 09 09 09 07 09 09 09 09 09 09 09 09 07 09 09 09 19 06
06 00 00 00 00 04 06 06 06 06 06 06 06 06 04 00 00 00 00 06
06 00 00 00 00 04 00 06 06 06 06 06 06 00 04 00 00 00 00 06
06 00 00 00 00 04 00 00 06 06 06 06 00 00 04 00 00 00 00 06
06 00 00 00 00 04 00 00 00 06 06 00 00 00 04 01 00 00 00 06
06 00 00 00 01 04 00 00 01 00 00 00 00 00 04 00 00 00 00 06
06 00 00 00 00 04 04 04 00 00 00 00 04 04 04 00 01 00 00 06
06 00 00 00 00 03 00 04 00 02 00 03 04 00 00 00 00 00 00 06
06 00 00 00 00 00 02 04 00 00 00 00 04 00 00 00 02 00 00 06
06 16 08 08 08 08 08 07 08 08 08 08 07 08 08 08 08 08 17 06
06 18 09 09 09 09 09 07 09 09 09 09 07 09 09 09 09 09 19 06
06 00 00 02 03 00 00 04 06 06 06 06 04 00 00 03 00 00 00 06
06 00 00 00 00 00 00 04 00 02 00 00 04 00 00 00 00 00 00 06
06 00 00 00 00 00 00 04 04 04 04 04 04 00 00 00 00 00 00 06
06 00 00 00 00 01 00 04 04 04 04 04 04 00 03 00 00 00 00 06
06 00 00 00 00 00 03 04 04 04 04 04 04 00 00 00 00 00 00 06
06 00 00 00 00 00 00 04 04 04 04 04 04 00 00 00 00 00 00 06
06 00 00 00 00 00 00 00 04 00 00 04 00 00 02 00 00 00 00 06
06 00 00 00 00 00 00 00 04 02 00 04 00 00 00 00 00 00 00 06
06 16 08 08 08 08 08 08 07 08 08 07 08 08 08 08 08 08 17 06
06 10 05 05 05 05 05 05 07 05 05 07 05 05 05 05 05 05 11 06
06 10 05 05 05 05 05 05 07 07 07 07 05 05 05 05 05 05 11 06
06 10 05 05 05 05 05 05 07 05 05 07 05 05 05 05 05 05 11 06
06 10 05 05 05 05 05 05 07 05 05 07 05 05 05 05 05 05 11 06
06 10 05 05 05 05 05 05 07 05 05 07 05 05 05 05 05 05 11 06
06 18 09 09 09 09 09 09 07 09 09 07 09 09 09 09 09 09 19 06
06 00 00 00 00 03 00 04 04 00 00 04 04 03 00 00 00 00 00 06
06 00 00 02 00 04 04 04 00 06 06 00 04 04 04 00 00 00 00 06
06 00 00 00 00 04 00 00 01 00 02 00 00 00 04 00 00 00 00 06
06 16 08 08 08 07 08 08 08 08 08 08 08 08 07 08 08 08 17 06
06 18 09 09 09 07 09 09 09 09 09 09 09 09 07 09 09 09 19 06
06 06 06 06 00 04 00 00 00 00 00 00 00 00 04 00 06 06 06 06
06 06 06 06 00 04 00 00 00 00 00 02 00 00 04 00 06 06 06 06
06 06 06 06 00 04 00 00 00 00 00 00 00 00 04 00 06 06 06 06
06 06 00 00 00 04 04 04 04 04 04 04 04 04 04 00 00 00 06 06
06 00 00 00 00 00 00 03 00 04 04 00 00 01 00 00 00 00 00 06
06 00 00 00 00 00 00 00 00 04 04 00 00 00 02 00 00 00 00 06
06 00 00 00 00 00 00 00 00 04 04 00 00 00 00 00 00 00 00 06
06 00 00 00 00 00 00 00 00 04 04 00 00 00 00 00 00 00 00 06
06 00 00 00 00 00 00 00 00 04 04 00 00 00 00 00 00 00 00 06
06 06 06 06 06 06 06 06 06 06 06 06 06 06 06 06 06 06 06 06